date,season,holiday,weekday,working_day,weather_condition,registered,casual,total_rentals,total_registered,total_casual,hourly_peak_registered,hourly_peak_casual,hourly_peak_total,avg_rentals_per_hour,rental_category
2011-01-01,1,0,6,0,2,654,331,985,654,331,14,13,15,41.041666666666664,Rendah
2011-01-02,1,0,0,0,2,670,131,801,670,131,11,11,11,34.82608695652174,Rendah
2011-01-03,1,0,1,1,1,1229,120,1349,1229,120,5,12,14,61.31818181818182,Rendah
2011-01-04,1,0,2,1,1,1454,108,1562,1454,108,13,9,13,67.91304347826087,Rendah
2011-01-05,1,0,3,1,1,1518,82,1600,1518,82,3,6,3,69.56521739130434,Rendah
2011-01-06,1,0,4,1,1,1518,88,1606,1518,88,2,7,2,69.82608695652173,Rendah
2011-01-07,1,0,5,1,2,1362,148,1510,1362,148,1,1,1,65.65217391304348,Rendah
2011-01-08,1,0,6,0,2,891,68,959,891,68,6,7,6,39.958333333333336,Rendah
2011-01-09,1,0,0,0,1,768,54,822,768,54,5,9,9,34.25,Rendah
2011-01-10,1,0,1,1,1,1280,41,1321,1280,41,1,5,1,55.041666666666664,Rendah
2011-01-11,1,0,2,1,2,1220,43,1263,1220,43,23,4,23,57.40909090909091,Rendah
2011-01-12,1,0,3,1,1,1137,25,1162,1137,25,6,5,6,52.81818181818182,Rendah
2011-01-13,1,0,4,1,1,1368,38,1406,1368,38,21,21,21,58.583333333333336,Rendah
2011-01-14,1,0,5,1,1,1367,54,1421,1367,54,20,3,5,61.78260869565217,Rendah
2011-01-15,1,0,6,0,2,1026,222,1248,1026,222,3,4,3,52.0,Rendah
2011-01-16,1,0,0,0,1,953,251,1204,953,251,1,3,1,50.166666666666664,Rendah
2011-01-17,1,1,1,0,2,883,117,1000,883,117,6,3,1,41.666666666666664,Rendah
2011-01-18,1,0,2,1,2,674,9,683,674,9,18,15,18,56.916666666666664,Rendah
2011-01-19,1,0,3,1,2,1572,78,1650,1572,78,7,12,7,71.73913043478261,Rendah
2011-01-20,1,0,4,1,2,1844,83,1927,1844,83,7,12,7,80.29166666666667,Rendah
2011-01-21,1,0,5,1,1,1468,75,1543,1468,75,7,11,7,64.29166666666667,Rendah
2011-01-22,1,0,6,0,1,888,93,981,888,93,13,11,13,42.65217391304348,Rendah
2011-01-23,1,0,0,0,1,836,150,986,836,150,11,9,9,42.869565217391305,Rendah
2011-01-24,1,0,1,1,1,1330,86,1416,1330,86,13,8,13,61.56521739130435,Rendah
2011-01-25,1,0,2,1,2,1799,186,1985,1799,186,3,7,3,86.30434782608695,Rendah
2011-01-26,1,0,3,1,3,472,34,506,472,34,1,5,1,31.625,Rendah
2011-01-27,1,0,4,1,1,416,15,431,416,15,13,15,13,53.875,Rendah
2011-01-28,1,0,5,1,2,1129,38,1167,1129,38,2,10,2,50.73913043478261,Rendah
2011-01-29,1,0,6,0,1,975,123,1098,975,123,8,8,8,47.73913043478261,Rendah
2011-01-30,1,0,0,0,1,956,140,1096,956,140,6,8,8,47.65217391304348,Rendah
2011-01-31,1,0,1,1,2,1459,42,1501,1459,42,0,4,0,62.541666666666664,Rendah
2011-02-01,1,0,2,1,2,1313,47,1360,1313,47,8,6,8,59.130434782608695,Rendah
2011-02-02,1,0,3,1,2,1454,72,1526,1454,72,8,6,8,63.583333333333336,Rendah
2011-02-03,1,0,4,1,1,1489,61,1550,1489,61,22,1,22,67.3913043478261,Rendah
2011-02-04,1,0,5,1,2,1620,88,1708,1620,88,21,3,21,74.26086956521739,Rendah
2011-02-05,1,0,6,0,2,905,100,1005,905,100,7,6,8,41.875,Rendah
2011-02-06,1,0,0,0,1,1269,354,1623,1269,354,2,4,2,67.625,Rendah
2011-02-07,1,0,1,1,1,1592,120,1712,1592,120,21,5,21,71.33333333333333,Rendah
2011-02-08,1,0,2,1,1,1466,64,1530,1466,64,21,10,21,63.75,Rendah
2011-02-09,1,0,3,1,2,1552,53,1605,1552,53,20,5,20,69.78260869565217,Rendah
2011-02-10,1,0,4,1,1,1491,47,1538,1491,47,19,1,19,66.8695652173913,Rendah
2011-02-11,1,0,5,1,1,1597,149,1746,1597,149,17,22,17,79.36363636363636,Rendah
2011-02-12,1,0,6,0,1,1184,288,1472,1184,288,0,0,0,61.333333333333336,Rendah
2011-02-13,1,0,0,0,1,1192,397,1589,1192,397,23,21,23,69.08695652173913,Rendah
2011-02-14,1,0,1,1,1,1705,208,1913,1705,208,16,20,16,79.70833333333333,Rendah
2011-02-15,1,0,2,1,1,1675,140,1815,1675,140,15,23,15,78.91304347826087,Rendah
2011-02-16,1,0,3,1,1,1897,218,2115,1897,218,23,21,23,91.95652173913044,Sedang
2011-02-17,1,0,4,1,1,2216,259,2475,2216,259,14,22,14,103.125,Sedang
2011-02-18,1,0,5,1,1,2348,579,2927,2348,579,23,20,23,121.95833333333333,Sedang
2011-02-19,1,0,6,0,1,1103,532,1635,1103,532,19,20,20,68.125,Rendah
2011-02-20,1,0,0,0,1,1173,639,1812,1173,639,18,19,19,78.78260869565217,Rendah
2011-02-21,1,1,1,0,2,912,195,1107,912,195,19,15,19,46.125,Rendah
2011-02-22,1,0,2,1,1,1376,74,1450,1376,74,16,13,16,80.55555555555556,Rendah
2011-02-23,1,0,3,1,1,1778,139,1917,1778,139,6,13,6,83.34782608695652,Rendah
2011-02-24,1,0,4,1,2,1707,100,1807,1707,100,5,10,5,78.56521739130434,Rendah
2011-02-25,1,0,5,1,2,1341,120,1461,1341,120,13,8,13,63.52173913043478,Rendah
2011-02-26,1,0,6,0,1,1545,424,1969,1545,424,10,10,10,82.04166666666667,Rendah
2011-02-27,1,0,0,0,1,1708,694,2402,1708,694,9,9,9,104.43478260869566,Sedang
2011-02-28,1,0,1,1,2,1365,81,1446,1365,81,1,2,1,65.72727272727273,Rendah
2011-03-01,1,0,2,1,1,1714,137,1851,1714,137,10,7,10,77.125,Rendah
2011-03-02,1,0,3,1,1,1903,231,2134,1903,231,1,6,10,88.91666666666667,Sedang
2011-03-03,1,0,4,1,1,1562,123,1685,1562,123,1,7,1,70.20833333333333,Rendah
2011-03-04,1,0,5,1,2,1730,214,1944,1730,214,1,8,1,81.0,Rendah
2011-03-05,1,0,6,0,2,1437,640,2077,1437,640,6,8,8,86.54166666666667,Sedang
2011-03-06,1,0,0,0,2,491,114,605,491,114,5,5,5,26.304347826086957,Rendah
2011-03-07,1,0,1,1,1,1628,244,1872,1628,244,9,6,8,81.3913043478261,Rendah
2011-03-08,1,0,2,1,1,1817,316,2133,1817,316,23,8,23,88.875,Sedang
2011-03-09,1,0,3,1,2,1700,191,1891,1700,191,23,22,23,78.79166666666667,Rendah
2011-03-10,1,0,4,1,3,577,46,623,577,46,6,9,6,28.318181818181817,Rendah
2011-03-11,1,0,5,1,2,1730,247,1977,1730,247,20,2,20,85.95652173913044,Rendah
2011-03-12,1,0,6,0,1,1408,724,2132,1408,724,4,4,4,88.83333333333333,Sedang
2011-03-13,1,0,0,0,1,1435,982,2417,1435,982,2,2,2,105.08695652173913,Sedang
2011-03-14,1,0,1,1,1,1687,359,2046,1687,359,3,3,3,88.95652173913044,Sedang
2011-03-15,1,0,2,1,2,1767,289,2056,1767,289,17,21,17,89.3913043478261,Sedang
2011-03-16,1,0,3,1,2,1871,321,2192,1871,321,16,1,16,95.30434782608695,Sedang
2011-03-17,1,0,4,1,1,2320,424,2744,2320,424,16,2,1,114.33333333333333,Sedang
2011-03-18,1,0,5,1,1,2355,884,3239,2355,884,15,0,0,140.82608695652175,Sedang
2011-03-19,1,0,6,0,1,1693,1424,3117,1693,1424,21,23,22,129.875,Sedang
2011-03-20,1,0,0,0,1,1424,1047,2471,1424,1047,0,22,22,102.95833333333333,Sedang
2011-03-21,2,0,1,1,2,1676,401,2077,1676,401,0,0,0,90.30434782608695,Sedang
2011-03-22,2,0,2,1,1,2243,460,2703,2243,460,14,21,14,112.625,Sedang
2011-03-23,2,0,3,1,2,1918,203,2121,1918,203,13,22,22,92.21739130434783,Sedang
2011-03-24,2,0,4,1,2,1699,166,1865,1699,166,22,19,22,77.70833333333333,Rendah
2011-03-25,2,0,5,1,1,1910,300,2210,1910,300,13,20,13,92.08333333333333,Sedang
2011-03-26,2,0,6,0,1,1515,981,2496,1515,981,18,21,21,104.0,Sedang
2011-03-27,2,0,0,0,2,1221,472,1693,1221,472,16,18,19,73.6086956521739,Rendah
2011-03-28,2,0,1,1,1,1806,222,2028,1806,222,11,20,11,88.17391304347827,Sedang
2011-03-29,2,0,2,1,1,2108,317,2425,2108,317,11,21,20,101.04166666666667,Sedang
2011-03-30,2,0,3,1,2,1368,168,1536,1368,168,11,14,11,64.0,Rendah
2011-03-31,2,0,4,1,3,1506,179,1685,1506,179,11,17,11,70.20833333333333,Rendah
2011-04-01,2,0,5,1,2,1920,307,2227,1920,307,20,19,20,92.79166666666667,Sedang
2011-04-02,2,0,6,0,2,1354,898,2252,1354,898,14,19,14,93.83333333333333,Sedang
2011-04-03,2,0,0,0,1,1598,1651,3249,1598,1651,19,17,16,135.375,Sedang
2011-04-04,2,0,1,1,1,2381,734,3115,2381,734,11,20,21,129.79166666666666,Sedang
2011-04-05,2,0,2,1,2,1628,167,1795,1628,167,21,20,20,74.79166666666667,Rendah
2011-04-06,2,0,3,1,1,2395,413,2808,2395,413,11,20,20,117.0,Sedang
2011-04-07,2,0,4,1,1,2570,571,3141,2570,571,11,21,20,130.875,Sedang
2011-04-08,2,0,5,1,2,1299,172,1471,1299,172,11,15,11,61.291666666666664,Rendah
2011-04-09,2,0,6,0,2,1576,879,2455,1576,879,20,20,20,102.29166666666667,Sedang
2011-04-10,2,0,0,0,2,1707,1188,2895,1707,1188,19,18,18,120.625,Sedang
2011-04-11,2,0,1,1,2,2493,855,3348,2493,855,19,19,19,145.56521739130434,Sedang
2011-04-12,2,0,2,1,2,1777,257,2034,1777,257,19,19,19,84.75,Sedang
2011-04-13,2,0,3,1,2,1953,209,2162,1953,209,20,20,20,90.08333333333333,Sedang
2011-04-14,2,0,4,1,1,2738,529,3267,2738,529,19,17,19,136.125,Sedang
2011-04-15,2,1,5,0,1,2484,642,3126,2484,642,10,18,19,130.25,Sedang
2011-04-16,2,0,6,0,3,674,121,795,674,121,17,17,17,33.125,Rendah
2011-04-17,2,0,0,0,1,2186,1558,3744,2186,1558,17,15,17,156.0,Sedang
2011-04-18,2,0,1,1,1,2760,669,3429,2760,669,19,19,19,142.875,Sedang
2011-04-19,2,0,2,1,2,2795,409,3204,2795,409,20,17,20,133.5,Sedang
2011-04-20,2,0,3,1,1,3331,613,3944,3331,613,19,21,20,164.33333333333334,Sedang
2011-04-21,2,0,4,1,1,3444,745,4189,3444,745,19,19,19,174.54166666666666,Sedang
2011-04-22,2,0,5,1,2,1506,177,1683,1506,177,10,12,10,70.125,Rendah
2011-04-23,2,0,6,0,2,2574,1462,4036,2574,1462,18,16,18,168.16666666666666,Sedang
2011-04-24,2,0,0,0,2,2481,1710,4191,2481,1710,15,15,15,174.625,Sedang
2011-04-25,2,0,1,1,1,3300,773,4073,3300,773,19,19,19,169.70833333333334,Sedang
2011-04-26,2,0,2,1,1,3722,678,4400,3722,678,20,19,20,183.33333333333334,Sedang
2011-04-27,2,0,3,1,2,3325,547,3872,3325,547,19,19,19,161.33333333333334,Sedang
2011-04-28,2,0,4,1,2,3489,569,4058,3489,569,20,21,20,169.08333333333334,Sedang
2011-04-29,2,0,5,1,1,3717,878,4595,3717,878,19,17,19,191.45833333333334,Tinggi
2011-04-30,2,0,6,0,1,3347,1965,5312,3347,1965,17,17,17,221.33333333333334,Tinggi
2011-05-01,2,0,0,0,2,2213,1138,3351,2213,1138,15,15,15,139.625,Sedang
2011-05-02,2,0,1,1,2,3554,847,4401,3554,847,19,2,19,183.375,Sedang
2011-05-03,2,0,2,1,2,3848,603,4451,3848,603,20,20,20,185.45833333333334,Sedang
2011-05-04,2,0,3,1,2,2378,255,2633,2378,255,19,21,19,109.70833333333333,Sedang
2011-05-05,2,0,4,1,1,3819,614,4433,3819,614,19,19,19,184.70833333333334,Sedang
2011-05-06,2,0,5,1,1,3714,894,4608,3714,894,19,17,19,192.0,Tinggi
2011-05-07,2,0,6,0,1,3102,1612,4714,3102,1612,14,15,15,196.41666666666666,Tinggi
2011-05-08,2,0,0,0,1,2932,1401,4333,2932,1401,18,15,15,180.54166666666666,Sedang
2011-05-09,2,0,1,1,1,3698,664,4362,3698,664,19,20,19,181.75,Sedang
2011-05-10,2,0,2,1,1,4109,694,4803,4109,694,19,19,19,200.125,Tinggi
2011-05-11,2,0,3,1,1,3632,550,4182,3632,550,10,21,10,174.25,Sedang
2011-05-12,2,0,4,1,1,4169,695,4864,4169,695,19,20,19,202.66666666666666,Tinggi
2011-05-13,2,0,5,1,2,3413,692,4105,3413,692,19,16,19,171.04166666666666,Sedang
2011-05-14,2,0,6,0,2,2507,902,3409,2507,902,17,18,20,142.04166666666666,Sedang
2011-05-15,2,0,0,0,2,2971,1582,4553,2971,1582,18,17,17,189.70833333333334,Tinggi
2011-05-16,2,0,1,1,1,3185,773,3958,3185,773,20,16,20,164.91666666666666,Sedang
2011-05-17,2,0,2,1,2,3445,678,4123,3445,678,19,19,19,171.79166666666666,Sedang
2011-05-18,2,0,3,1,2,3319,536,3855,3319,536,19,19,19,160.625,Sedang
2011-05-19,2,0,4,1,2,3840,735,4575,3840,735,19,21,19,190.625,Tinggi
2011-05-20,2,0,5,1,1,4008,909,4917,4008,909,19,20,19,204.875,Tinggi
2011-05-21,2,0,6,0,1,3547,2258,5805,3547,2258,17,17,17,241.875,Tinggi
2011-05-22,2,0,0,0,1,3084,1576,4660,3084,1576,15,15,15,194.16666666666666,Tinggi
2011-05-23,2,0,1,1,2,3438,836,4274,3438,836,20,13,20,178.08333333333334,Sedang
2011-05-24,2,0,2,1,2,3833,659,4492,3833,659,19,20,20,187.16666666666666,Sedang
2011-05-25,2,0,3,1,1,4238,740,4978,4238,740,19,19,19,207.41666666666666,Tinggi
2011-05-26,2,0,4,1,1,3919,758,4677,3919,758,10,20,19,194.875,Tinggi
2011-05-27,2,0,5,1,1,3808,871,4679,3808,871,19,17,19,194.95833333333334,Tinggi
2011-05-28,2,0,6,0,1,2757,2001,4758,2757,2001,15,18,18,198.25,Tinggi
2011-05-29,2,0,0,0,1,2433,2355,4788,2433,2355,14,15,15,199.5,Tinggi
2011-05-30,2,1,1,0,1,2549,1549,4098,2549,1549,15,14,14,170.75,Sedang
2011-05-31,2,0,2,1,1,3309,673,3982,3309,673,19,19,19,165.91666666666666,Sedang
2011-06-01,2,0,3,1,2,3461,513,3974,3461,513,19,19,19,165.58333333333334,Sedang
2011-06-02,2,0,4,1,1,4232,736,4968,4232,736,19,19,19,207.0,Tinggi
2011-06-03,2,0,5,1,1,4414,898,5312,4414,898,20,20,20,221.33333333333334,Tinggi
2011-06-04,2,0,6,0,1,3473,1869,5342,3473,1869,18,16,15,222.58333333333334,Tinggi
2011-06-05,2,0,0,0,2,3221,1685,4906,3221,1685,19,16,17,204.41666666666666,Tinggi
2011-06-06,2,0,1,1,1,3875,673,4548,3875,673,19,21,19,189.5,Tinggi
2011-06-07,2,0,2,1,1,4070,763,4833,4070,763,20,20,20,201.375,Tinggi
2011-06-08,2,0,3,1,1,3725,676,4401,3725,676,10,19,19,183.375,Sedang
2011-06-09,2,0,4,1,2,3352,563,3915,3352,563,20,21,20,163.125,Sedang
2011-06-10,2,0,5,1,1,3771,815,4586,3771,815,19,20,19,191.08333333333334,Tinggi
2011-06-11,2,0,6,0,1,3237,1729,4966,3237,1729,15,18,18,206.91666666666666,Tinggi
2011-06-12,2,0,0,0,1,2993,1467,4460,2993,1467,15,14,14,185.83333333333334,Sedang
2011-06-13,2,0,1,1,1,4157,863,5020,4157,863,19,22,19,209.16666666666666,Tinggi
2011-06-14,2,0,2,1,1,4164,727,4891,4164,727,19,19,19,203.79166666666666,Tinggi
2011-06-15,2,0,3,1,1,4411,769,5180,4411,769,19,19,19,215.83333333333334,Tinggi
2011-06-16,2,0,4,1,2,3222,545,3767,3222,545,10,21,10,156.95833333333334,Sedang
2011-06-17,2,0,5,1,1,3981,863,4844,3981,863,19,19,19,201.83333333333334,Tinggi
2011-06-18,2,0,6,0,1,3312,1807,5119,3312,1807,18,19,18,213.29166666666666,Tinggi
2011-06-19,2,0,0,0,2,3105,1639,4744,3105,1639,18,19,19,197.66666666666666,Tinggi
2011-06-20,2,0,1,1,2,3311,699,4010,3311,699,19,19,19,167.08333333333334,Sedang
2011-06-21,3,0,2,1,2,4061,774,4835,4061,774,19,22,19,201.45833333333334,Tinggi
2011-06-22,3,0,3,1,1,3846,661,4507,3846,661,19,19,19,187.79166666666666,Tinggi
2011-06-23,3,0,4,1,2,4044,746,4790,4044,746,19,22,19,199.58333333333334,Tinggi
2011-06-24,3,0,5,1,1,4022,969,4991,4022,969,19,21,19,207.95833333333334,Tinggi
2011-06-25,3,0,6,0,1,3420,1782,5202,3420,1782,21,18,18,216.75,Tinggi
2011-06-26,3,0,0,0,1,3385,1920,5305,3385,1920,18,15,18,221.04166666666666,Tinggi
2011-06-27,3,0,1,1,2,3854,854,4708,3854,854,19,19,19,196.16666666666666,Tinggi
2011-06-28,3,0,2,1,1,3916,732,4648,3916,732,19,19,19,193.66666666666666,Tinggi
2011-06-29,3,0,3,1,1,4377,848,5225,4377,848,20,19,20,217.70833333333334,Tinggi
2011-06-30,3,0,4,1,1,4488,1027,5515,4488,1027,10,20,19,229.79166666666666,Tinggi
2011-07-01,3,0,5,1,1,4116,1246,5362,4116,1246,10,19,10,223.41666666666666,Tinggi
2011-07-02,3,0,6,0,1,2915,2204,5119,2915,2204,14,18,15,213.29166666666666,Tinggi
2011-07-03,3,0,0,0,2,2367,2282,4649,2367,2282,18,15,15,193.70833333333334,Tinggi
2011-07-04,3,1,1,0,2,2978,3065,6043,2978,3065,23,15,23,251.79166666666666,
2011-07-05,3,0,2,1,1,3634,1031,4665,3634,1031,19,18,19,194.375,Tinggi
2011-07-06,3,0,3,1,1,3845,784,4629,3845,784,19,19,19,192.875,Tinggi
2011-07-07,3,0,4,1,1,3838,754,4592,3838,754,20,19,19,191.33333333333334,Tinggi
2011-07-08,3,0,5,1,2,3348,692,4040,3348,692,10,13,10,168.33333333333334,Sedang
2011-07-09,3,0,6,0,1,3348,1988,5336,3348,1988,15,17,15,222.33333333333334,Tinggi
2011-07-10,3,0,0,0,1,3138,1743,4881,3138,1743,14,19,14,203.375,Tinggi
2011-07-11,3,0,1,1,1,3363,723,4086,3363,723,19,21,19,170.25,Sedang
2011-07-12,3,0,2,1,1,3596,662,4258,3596,662,20,22,20,177.41666666666666,Sedang
2011-07-13,3,0,3,1,1,3594,748,4342,3594,748,10,21,19,180.91666666666666,Sedang
2011-07-14,3,0,4,1,1,4196,888,5084,4196,888,19,20,19,211.83333333333334,Tinggi
2011-07-15,3,0,5,1,1,4220,1318,5538,4220,1318,10,21,19,230.75,Tinggi
2011-07-16,3,0,6,0,1,3505,2418,5923,3505,2418,14,19,15,246.79166666666666,Tinggi
2011-07-17,3,0,0,0,1,3296,2006,5302,3296,2006,15,15,15,220.91666666666666,Tinggi
2011-07-18,3,0,1,1,1,3617,841,4458,3617,841,20,22,20,185.75,Sedang
2011-07-19,3,0,2,1,1,3789,752,4541,3789,752,20,20,20,189.20833333333334,Tinggi
2011-07-20,3,0,3,1,1,3688,644,4332,3688,644,20,20,20,180.5,Sedang
2011-07-21,3,0,4,1,2,3152,632,3784,3152,632,19,21,19,157.66666666666666,Sedang
2011-07-22,3,0,5,1,1,2825,562,3387,2825,562,10,22,10,141.125,Sedang
2011-07-23,3,0,6,0,1,2298,987,3285,2298,987,15,16,15,136.875,Sedang
2011-07-24,3,0,0,0,1,2556,1050,3606,2556,1050,16,15,16,150.25,Sedang
2011-07-25,3,0,1,1,1,3272,568,3840,3272,568,20,21,20,160.0,Sedang
2011-07-26,3,0,2,1,1,3840,750,4590,3840,750,20,19,20,191.25,Tinggi
2011-07-27,3,0,3,1,1,3901,755,4656,3901,755,19,21,19,194.0,Tinggi
2011-07-28,3,0,4,1,1,3784,606,4390,3784,606,20,20,20,182.91666666666666,Sedang
2011-07-29,3,0,5,1,1,3176,670,3846,3176,670,19,22,19,160.25,Sedang
2011-07-30,3,0,6,0,1,2916,1559,4475,2916,1559,14,18,14,186.45833333333334,Sedang
2011-07-31,3,0,0,0,1,2778,1524,4302,2778,1524,20,14,14,179.25,Sedang
2011-08-01,3,0,1,1,1,3537,729,4266,3537,729,20,19,20,177.75,Sedang
2011-08-02,3,0,2,1,1,4044,801,4845,4044,801,19,21,19,201.875,Tinggi
2011-08-03,3,0,3,1,2,3107,467,3574,3107,467,20,21,20,148.91666666666666,Sedang
2011-08-04,3,0,4,1,2,3777,799,4576,3777,799,19,19,19,190.66666666666666,Tinggi
2011-08-05,3,0,5,1,1,3843,1023,4866,3843,1023,19,20,19,202.75,Tinggi
2011-08-06,3,0,6,0,2,2773,1521,4294,2773,1521,15,15,15,178.91666666666666,Sedang
2011-08-07,3,0,0,0,1,2487,1298,3785,2487,1298,14,14,14,157.70833333333334,Sedang
2011-08-08,3,0,1,1,1,3480,846,4326,3480,846,20,13,20,180.25,Sedang
2011-08-09,3,0,2,1,1,3695,907,4602,3695,907,20,20,20,191.75,Tinggi
2011-08-10,3,0,3,1,1,3896,884,4780,3896,884,19,21,19,199.16666666666666,Tinggi
2011-08-11,3,0,4,1,1,3980,812,4792,3980,812,20,19,19,199.66666666666666,Tinggi
2011-08-12,3,0,5,1,1,3854,1051,4905,3854,1051,19,21,19,204.375,Tinggi
2011-08-13,3,0,6,0,2,2646,1504,4150,2646,1504,14,14,14,172.91666666666666,Sedang
2011-08-14,3,0,0,0,2,2482,1338,3820,2482,1338,16,15,15,159.16666666666666,Sedang
2011-08-15,3,0,1,1,1,3563,775,4338,3563,775,19,20,19,180.75,Sedang
2011-08-16,3,0,2,1,1,4004,721,4725,4004,721,19,19,19,196.875,Tinggi
2011-08-17,3,0,3,1,1,4026,668,4694,4026,668,19,20,20,195.58333333333334,Tinggi
2011-08-18,3,0,4,1,1,3166,639,3805,3166,639,10,16,10,158.54166666666666,Sedang
2011-08-19,3,0,5,1,2,3356,797,4153,3356,797,19,20,19,173.04166666666666,Sedang
2011-08-20,3,0,6,0,1,3277,1914,5191,3277,1914,14,19,14,216.29166666666666,Tinggi
2011-08-21,3,0,0,0,1,2624,1249,3873,2624,1249,14,14,14,161.375,Sedang
2011-08-22,3,0,1,1,1,3925,833,4758,3925,833,20,16,20,198.25,Tinggi
2011-08-23,3,0,2,1,1,4614,1281,5895,4614,1281,16,17,16,245.625,Tinggi
2011-08-24,3,0,3,1,1,4181,949,5130,4181,949,20,20,20,213.75,Tinggi
2011-08-25,3,0,4,1,2,3107,435,3542,3107,435,10,13,10,147.58333333333334,Sedang
2011-08-26,3,0,5,1,1,3893,768,4661,3893,768,19,15,19,194.20833333333334,Tinggi
2011-08-27,3,0,6,0,2,889,226,1115,889,226,12,12,12,61.94444444444444,Rendah
2011-08-28,3,0,0,0,1,2919,1415,4334,2919,1415,4,5,5,254.94117647058823,Sedang
2011-08-29,3,0,1,1,1,3905,729,4634,3905,729,6,6,6,193.08333333333334,Tinggi
2011-08-30,3,0,2,1,1,4429,775,5204,4429,775,6,8,6,216.83333333333334,Tinggi
2011-08-31,3,0,3,1,1,4370,688,5058,4370,688,6,6,6,210.75,Tinggi
2011-09-01,3,0,4,1,1,4332,783,5115,4332,783,6,8,6,213.125,Tinggi
2011-09-02,3,0,5,1,2,3852,875,4727,3852,875,21,1,21,196.95833333333334,Tinggi
2011-09-03,3,0,6,0,1,2549,1935,4484,2549,1935,4,3,4,186.83333333333334,Sedang
2011-09-04,3,0,0,0,1,2419,2521,4940,2419,2521,1,2,1,205.83333333333334,Tinggi
2011-09-05,3,1,1,0,2,2115,1236,3351,2115,1236,2,2,2,139.625,Sedang
2011-09-06,3,0,2,1,3,2506,204,2710,2506,204,6,6,6,117.82608695652173,Sedang
2011-09-07,3,0,3,1,3,1878,118,1996,1878,118,20,5,20,83.16666666666667,Rendah
2011-09-08,3,0,4,1,3,1689,153,1842,1689,153,19,2,19,80.08695652173913,Rendah
2011-09-09,3,0,5,1,2,3127,417,3544,3127,417,4,4,4,147.66666666666666,Sedang
2011-09-10,3,0,6,0,1,3595,1750,5345,3595,1750,4,2,2,222.70833333333334,Tinggi
2011-09-11,3,0,0,0,1,3413,1633,5046,3413,1633,3,3,3,210.25,Tinggi
2011-09-12,3,0,1,1,1,4023,690,4713,4023,690,3,3,3,204.91304347826087,Tinggi
2011-09-13,3,0,2,1,1,4062,701,4763,4062,701,3,3,3,198.45833333333334,Tinggi
2011-09-14,3,0,3,1,1,4138,647,4785,4138,647,3,3,3,199.375,Tinggi
2011-09-15,3,0,4,1,2,3231,428,3659,3231,428,18,21,18,152.45833333333334,Sedang
2011-09-16,3,0,5,1,2,4018,742,4760,4018,742,3,3,3,198.33333333333334,Tinggi
2011-09-17,3,0,6,0,2,3077,1434,4511,3077,1434,22,1,22,187.95833333333334,Tinggi
2011-09-18,3,0,0,0,1,2921,1353,4274,2921,1353,2,23,23,178.08333333333334,Sedang
2011-09-19,3,0,1,1,2,3848,691,4539,3848,691,4,3,3,189.125,Tinggi
2011-09-20,3,0,2,1,2,3203,438,3641,3203,438,4,3,3,151.70833333333334,Sedang
2011-09-21,3,0,3,1,2,3813,539,4352,3813,539,3,3,3,181.33333333333334,Sedang
2011-09-22,3,0,4,1,2,4240,555,4795,4240,555,3,3,3,199.79166666666666,Tinggi
2011-09-23,4,0,5,1,2,2137,258,2395,2137,258,18,9,18,99.79166666666667,Sedang
2011-09-24,4,0,6,0,2,3647,1776,5423,3647,1776,23,3,23,225.95833333333334,Tinggi
2011-09-25,4,0,0,0,2,3466,1544,5010,3466,1544,2,3,2,208.75,Tinggi
2011-09-26,4,0,1,1,2,3946,684,4630,3946,684,3,2,3,192.91666666666666,Tinggi
2011-09-27,4,0,2,1,2,3643,477,4120,3643,477,3,3,3,171.66666666666666,Sedang
2011-09-28,4,0,3,1,2,3427,480,3907,3427,480,3,4,3,162.79166666666666,Sedang
2011-09-29,4,0,4,1,1,4186,653,4839,4186,653,3,4,3,201.625,Tinggi
2011-09-30,4,0,5,1,1,4372,830,5202,4372,830,3,3,3,216.75,Tinggi
2011-10-01,4,0,6,0,2,1949,480,2429,1949,480,3,2,3,101.20833333333333,Sedang
2011-10-02,4,0,0,0,2,2302,616,2918,2302,616,22,23,22,121.58333333333333,Sedang
2011-10-03,4,0,1,1,2,3240,330,3570,3240,330,3,3,3,148.75,Sedang
2011-10-04,4,0,2,1,1,3970,486,4456,3970,486,3,4,3,185.66666666666666,Sedang
2011-10-05,4,0,3,1,1,4267,559,4826,4267,559,4,3,4,201.08333333333334,Tinggi
2011-10-06,4,0,4,1,1,4126,639,4765,4126,639,3,3,3,198.54166666666666,Tinggi
2011-10-07,4,0,5,1,1,4036,949,4985,4036,949,3,3,3,207.70833333333334,Tinggi
2011-10-08,4,0,6,0,1,3174,2235,5409,3174,2235,22,1,1,225.375,Tinggi
2011-10-09,4,0,0,0,1,3114,2397,5511,3114,2397,2,0,0,229.625,Tinggi
2011-10-10,4,1,1,0,1,3603,1514,5117,3603,1514,4,22,4,213.20833333333334,Tinggi
2011-10-11,4,0,2,1,2,3896,667,4563,3896,667,3,3,3,190.125,Tinggi
2011-10-12,4,0,3,1,3,2199,217,2416,2199,217,18,18,18,100.66666666666667,Sedang
2011-10-13,4,0,4,1,2,2623,290,2913,2623,290,3,3,3,121.375,Sedang
2011-10-14,4,0,5,1,2,3115,529,3644,3115,529,3,2,3,151.83333333333334,Sedang
2011-10-15,4,0,6,0,1,3318,1899,5217,3318,1899,2,0,0,217.375,Tinggi
2011-10-16,4,0,0,0,1,3293,1748,5041,3293,1748,2,0,2,210.04166666666666,Tinggi
2011-10-17,4,0,1,1,1,3857,713,4570,3857,713,3,3,3,190.41666666666666,Tinggi
2011-10-18,4,0,2,1,2,4111,637,4748,4111,637,3,3,3,197.83333333333334,Tinggi
2011-10-19,4,0,3,1,3,2170,254,2424,2170,254,17,20,17,105.3913043478261,Sedang
2011-10-20,4,0,4,1,1,3724,471,4195,3724,471,2,2,2,174.79166666666666,Sedang
2011-10-21,4,0,5,1,1,3628,676,4304,3628,676,2,2,2,179.33333333333334,Sedang
2011-10-22,4,0,6,0,1,2809,1499,4308,2809,1499,3,1,0,179.5,Sedang
2011-10-23,4,0,0,0,1,2762,1619,4381,2762,1619,22,23,22,182.54166666666666,Sedang
2011-10-24,4,0,1,1,1,3488,699,4187,3488,699,2,2,2,174.45833333333334,Sedang
2011-10-25,4,0,2,1,1,3992,695,4687,3992,695,2,2,2,195.29166666666666,Tinggi
2011-10-26,4,0,3,1,2,3490,404,3894,3490,404,17,3,17,162.25,Sedang
2011-10-27,4,0,4,1,2,2419,240,2659,2419,240,17,2,2,110.79166666666667,Sedang
2011-10-28,4,0,5,1,2,3291,456,3747,3291,456,2,21,2,156.125,Sedang
2011-10-29,4,0,6,0,3,570,57,627,570,57,6,7,7,26.125,Rendah
2011-10-30,4,0,0,0,1,2446,885,3331,2446,885,22,22,22,138.79166666666666,Sedang
2011-10-31,4,0,1,1,1,3307,362,3669,3307,362,2,2,2,152.875,Sedang
2011-11-01,4,0,2,1,1,3658,410,4068,3658,410,2,1,2,169.5,Sedang
2011-11-02,4,0,3,1,1,3816,370,4186,3816,370,2,23,2,174.41666666666666,Sedang
2011-11-03,4,0,4,1,1,3656,318,3974,3656,318,2,1,2,165.58333333333334,Sedang
2011-11-04,4,0,5,1,2,3576,470,4046,3576,470,2,23,2,168.58333333333334,Sedang
2011-11-05,4,0,6,0,1,2770,1156,3926,2770,1156,21,23,23,163.58333333333334,Sedang
2011-11-06,4,0,0,0,1,2697,952,3649,2697,952,1,21,1,152.04166666666666,Sedang
2011-11-07,4,0,1,1,1,3662,373,4035,3662,373,2,1,2,168.125,Sedang
2011-11-08,4,0,2,1,1,3829,376,4205,3829,376,2,2,2,175.20833333333334,Sedang
2011-11-09,4,0,3,1,1,3804,305,4109,3804,305,2,22,2,171.20833333333334,Sedang
2011-11-10,4,0,4,1,2,2743,190,2933,2743,190,17,18,17,122.20833333333333,Sedang
2011-11-11,4,1,5,0,1,2928,440,3368,2928,440,2,23,2,140.33333333333334,Sedang
2011-11-12,4,0,6,0,1,2792,1275,4067,2792,1275,23,23,23,169.45833333333334,Sedang
2011-11-13,4,0,0,0,1,2713,1004,3717,2713,1004,23,21,23,154.875,Sedang
2011-11-14,4,0,1,1,1,3891,595,4486,3891,595,2,2,2,186.91666666666666,Sedang
2011-11-15,4,0,2,1,2,3746,449,4195,3746,449,17,0,17,174.79166666666666,Sedang
2011-11-16,4,0,3,1,3,1672,145,1817,1672,145,17,2,2,75.70833333333333,Rendah
2011-11-17,4,0,4,1,2,2914,139,3053,2914,139,2,2,2,127.20833333333333,Sedang
2011-11-18,4,0,5,1,1,3147,245,3392,3147,245,17,22,2,141.33333333333334,Sedang
2011-11-19,4,0,6,0,1,2720,943,3663,2720,943,0,23,0,152.625,Sedang
2011-11-20,4,0,0,0,2,2733,787,3520,2733,787,22,23,22,146.66666666666666,Sedang
2011-11-21,4,0,1,1,3,2545,220,2765,2545,220,17,19,17,115.20833333333333,Sedang
2011-11-22,4,0,2,1,3,1538,69,1607,1538,69,17,19,17,66.95833333333333,Rendah
2011-11-23,4,0,3,1,2,2454,112,2566,2454,112,17,23,17,106.91666666666667,Sedang
2011-11-24,4,1,4,0,1,935,560,1495,935,560,23,22,22,62.291666666666664,Rendah
2011-11-25,4,0,5,1,1,1697,1095,2792,1697,1095,23,0,0,116.33333333333333,Sedang
2011-11-26,4,0,6,0,1,1819,1249,3068,1819,1249,21,22,22,127.83333333333333,Sedang
2011-11-27,4,0,0,0,1,2261,810,3071,2261,810,1,23,1,127.95833333333333,Sedang
2011-11-28,4,0,1,1,1,3614,253,3867,3614,253,1,21,1,168.1304347826087,Sedang
2011-11-29,4,0,2,1,2,2818,96,2914,2818,96,16,15,16,121.41666666666667,Sedang
2011-11-30,4,0,3,1,1,3425,188,3613,3425,188,16,0,16,150.54166666666666,Sedang
2011-12-01,4,0,4,1,1,3545,182,3727,3545,182,16,22,16,155.29166666666666,Sedang
2011-12-02,4,0,5,1,1,3672,268,3940,3672,268,16,22,16,164.16666666666666,Sedang
2011-12-03,4,0,6,0,1,2908,706,3614,2908,706,20,23,20,150.58333333333334,Sedang
2011-12-04,4,0,0,0,1,2851,634,3485,2851,634,21,21,21,145.20833333333334,Sedang
2011-12-05,4,0,1,1,2,3578,233,3811,3578,233,1,20,1,158.79166666666666,Sedang
2011-12-06,4,0,2,1,3,2468,126,2594,2468,126,16,2,16,108.08333333333333,Sedang
2011-12-07,4,0,3,1,3,655,50,705,655,50,16,16,16,29.375,Rendah
2011-12-08,4,0,4,1,1,3172,150,3322,3172,150,16,23,16,138.41666666666666,Sedang
2011-12-09,4,0,5,1,1,3359,261,3620,3359,261,16,23,16,150.83333333333334,Sedang
2011-12-10,4,0,6,0,1,2688,502,3190,2688,502,22,23,23,132.91666666666666,Sedang
2011-12-11,4,0,0,0,1,2366,377,2743,2366,377,20,23,20,114.29166666666667,Sedang
2011-12-12,4,0,1,1,1,3167,143,3310,3167,143,16,22,16,137.91666666666666,Sedang
2011-12-13,4,0,2,1,1,3368,155,3523,3368,155,16,20,16,146.79166666666666,Sedang
2011-12-14,4,0,3,1,2,3562,178,3740,3562,178,16,23,16,155.83333333333334,Sedang
2011-12-15,4,0,4,1,2,3528,181,3709,3528,181,16,20,16,154.54166666666666,Sedang
2011-12-16,4,0,5,1,2,3399,178,3577,3399,178,16,22,16,149.04166666666666,Sedang
2011-12-17,4,0,6,0,2,2464,275,2739,2464,275,20,23,20,114.125,Sedang
2011-12-18,4,0,0,0,1,2211,220,2431,2211,220,21,0,0,101.29166666666667,Sedang
2011-12-19,4,0,1,1,1,3143,260,3403,3143,260,16,22,16,141.79166666666666,Sedang
2011-12-20,4,0,2,1,2,3534,216,3750,3534,216,16,2,16,156.25,Sedang
2011-12-21,1,0,3,1,2,2553,107,2660,2553,107,16,17,16,110.83333333333333,Sedang
2011-12-22,1,0,4,1,2,2841,227,3068,2841,227,16,0,1,127.83333333333333,Sedang
2011-12-23,1,0,5,1,1,2046,163,2209,2046,163,23,19,23,92.04166666666667,Sedang
2011-12-24,1,0,6,0,1,856,155,1011,856,155,21,0,21,42.125,Rendah
2011-12-25,1,0,0,0,1,451,303,754,451,303,23,18,22,32.78260869565217,Rendah
2011-12-26,1,1,1,0,1,887,430,1317,887,430,21,20,20,57.26086956521739,Rendah
2011-12-27,1,0,2,1,2,1059,103,1162,1059,103,14,15,14,48.416666666666664,Rendah
2011-12-28,1,0,3,1,1,2047,255,2302,2047,255,22,17,22,100.08695652173913,Sedang
2011-12-29,1,0,4,1,1,2169,254,2423,2169,254,22,18,22,100.95833333333333,Sedang
2011-12-30,1,0,5,1,1,2508,491,2999,2508,491,21,19,20,124.95833333333333,Sedang
2011-12-31,1,0,6,0,1,1820,665,2485,1820,665,18,19,18,103.54166666666667,Sedang
2012-01-01,1,0,0,0,1,1608,686,2294,1608,686,20,19,19,95.58333333333333,Sedang
2012-01-02,1,1,1,0,1,1707,244,1951,1707,244,16,16,16,84.82608695652173,Rendah
2012-01-03,1,0,2,1,1,2147,89,2236,2147,89,12,15,12,93.16666666666667,Sedang
2012-01-04,1,0,3,1,2,2273,95,2368,2273,95,12,16,12,98.66666666666667,Sedang
2012-01-05,1,0,4,1,1,3132,140,3272,3132,140,21,20,21,136.33333333333334,Sedang
2012-01-06,1,0,5,1,1,3791,307,4098,3791,307,21,19,21,170.75,Sedang
2012-01-07,1,0,6,0,1,3451,1070,4521,3451,1070,18,18,18,188.375,Tinggi
2012-01-08,1,0,0,0,1,2826,599,3425,2826,599,16,19,16,142.70833333333334,Sedang
2012-01-09,1,0,1,1,2,2270,106,2376,2270,106,12,12,12,99.0,Sedang
2012-01-10,1,0,2,1,1,3425,173,3598,3425,173,11,18,11,156.43478260869566,Sedang
2012-01-11,1,0,3,1,2,2085,92,2177,2085,92,11,13,11,90.70833333333333,Sedang
2012-01-12,1,0,4,1,2,3828,269,4097,3828,269,11,19,11,170.70833333333334,Sedang
2012-01-13,1,0,5,1,1,3040,174,3214,3040,174,11,19,11,133.91666666666666,Sedang
2012-01-14,1,0,6,0,1,2160,333,2493,2160,333,15,17,17,103.875,Sedang
2012-01-15,1,0,0,0,1,2027,284,2311,2027,284,15,15,15,96.29166666666667,Sedang
2012-01-16,1,1,1,0,1,2081,217,2298,2081,217,16,16,16,95.75,Sedang
2012-01-17,1,0,2,1,2,2808,127,2935,2808,127,20,19,20,127.6086956521739,Sedang
2012-01-18,1,0,3,1,1,3267,109,3376,3267,109,10,10,10,140.66666666666666,Sedang
2012-01-19,1,0,4,1,1,3162,130,3292,3162,130,10,19,10,137.16666666666666,Sedang
2012-01-20,1,0,5,1,2,3048,115,3163,3048,115,10,11,10,131.79166666666666,Sedang
2012-01-21,1,0,6,0,2,1234,67,1301,1234,67,17,15,17,54.208333333333336,Rendah
2012-01-22,1,0,0,0,2,1781,196,1977,1781,196,15,17,15,82.375,Rendah
2012-01-23,1,0,1,1,2,2287,145,2432,2287,145,20,18,20,101.33333333333333,Sedang
2012-01-24,1,0,2,1,1,3900,439,4339,3900,439,10,17,19,180.79166666666666,Sedang
2012-01-25,1,0,3,1,1,3803,467,4270,3803,467,10,15,10,177.91666666666666,Sedang
2012-01-26,1,0,4,1,2,3831,244,4075,3831,244,10,14,10,169.79166666666666,Sedang
2012-01-27,1,0,5,1,2,3187,269,3456,3187,269,19,17,19,144.0,Sedang
2012-01-28,1,0,6,0,1,3248,775,4023,3248,775,17,18,17,167.625,Sedang
2012-01-29,1,0,0,0,1,2685,558,3243,2685,558,18,15,18,135.125,Sedang
2012-01-30,1,0,1,1,1,3498,126,3624,3498,126,10,19,10,151.0,Sedang
2012-01-31,1,0,2,1,1,4185,324,4509,4185,324,19,19,19,187.875,Tinggi
2012-02-01,1,0,3,1,1,4275,304,4579,4275,304,20,16,19,190.79166666666666,Tinggi
2012-02-02,1,0,4,1,2,3571,190,3761,3571,190,19,17,19,156.70833333333334,Sedang
2012-02-03,1,0,5,1,1,3841,310,4151,3841,310,19,17,19,172.95833333333334,Sedang
2012-02-04,1,0,6,0,2,2448,384,2832,2448,384,14,17,17,118.0,Sedang
2012-02-05,1,0,0,0,2,2629,318,2947,2629,318,19,17,19,122.79166666666667,Sedang
2012-02-06,1,0,1,1,1,3578,206,3784,3578,206,9,16,9,164.52173913043478,Sedang
2012-02-07,1,0,2,1,1,4176,199,4375,4176,199,9,22,9,182.29166666666666,Sedang
2012-02-08,1,0,3,1,2,2693,109,2802,2693,109,9,14,9,116.75,Sedang
2012-02-09,1,0,4,1,1,3667,163,3830,3667,163,9,15,9,159.58333333333334,Sedang
2012-02-10,1,0,5,1,2,3604,227,3831,3604,227,9,17,9,159.625,Sedang
2012-02-11,1,0,6,0,3,1977,192,2169,1977,192,14,15,15,90.375,Sedang
2012-02-12,1,0,0,0,1,1456,73,1529,1456,73,16,17,17,63.708333333333336,Rendah
2012-02-13,1,0,1,1,1,3328,94,3422,3328,94,9,14,9,142.58333333333334,Sedang
2012-02-14,1,0,2,1,2,3787,135,3922,3787,135,9,18,18,163.41666666666666,Sedang
2012-02-15,1,0,3,1,1,4028,141,4169,4028,141,9,18,9,173.70833333333334,Sedang
2012-02-16,1,0,4,1,2,2931,74,3005,2931,74,9,9,9,125.20833333333333,Sedang
2012-02-17,1,0,5,1,1,3805,349,4154,3805,349,9,17,9,173.08333333333334,Sedang
2012-02-18,1,0,6,0,1,2883,1435,4318,2883,1435,16,16,16,179.91666666666666,Sedang
2012-02-19,1,0,0,0,2,2071,618,2689,2071,618,14,16,14,112.04166666666667,Sedang
2012-02-20,1,1,1,0,1,2627,502,3129,2627,502,13,13,13,136.04347826086956,Sedang
2012-02-21,1,0,2,1,1,3614,163,3777,3614,163,7,14,7,164.2173913043478,Sedang
2012-02-22,1,0,3,1,1,4379,394,4773,4379,394,7,16,7,198.875,Tinggi
2012-02-23,1,0,4,1,1,4546,516,5062,4546,516,16,10,16,210.91666666666666,Tinggi
2012-02-24,1,0,5,1,2,3241,246,3487,3241,246,7,12,7,145.29166666666666,Sedang
2012-02-25,1,0,6,0,1,2415,317,2732,2415,317,11,12,11,113.83333333333333,Sedang
2012-02-26,1,0,0,0,1,2874,515,3389,2874,515,14,14,14,141.20833333333334,Sedang
2012-02-27,1,0,1,1,1,4069,253,4322,4069,253,17,16,16,180.08333333333334,Sedang
2012-02-28,1,0,2,1,1,4134,229,4363,4134,229,7,16,7,181.79166666666666,Sedang
2012-02-29,1,0,3,1,2,1769,65,1834,1769,65,15,5,5,79.73913043478261,Rendah
2012-03-01,1,0,4,1,1,4665,325,4990,4665,325,6,15,15,207.91666666666666,Tinggi
2012-03-02,1,0,5,1,2,2948,246,3194,2948,246,6,9,6,133.08333333333334,Sedang
2012-03-03,1,0,6,0,2,3110,956,4066,3110,956,14,14,14,169.41666666666666,Sedang
2012-03-04,1,0,0,0,1,2713,710,3423,2713,710,10,11,11,142.625,Sedang
2012-03-05,1,0,1,1,1,3130,203,3333,3130,203,6,14,6,138.875,Sedang
2012-03-06,1,0,2,1,1,3735,221,3956,3735,221,6,13,6,164.83333333333334,Sedang
2012-03-07,1,0,3,1,1,4484,432,4916,4484,432,6,15,15,204.83333333333334,Tinggi
2012-03-08,1,0,4,1,1,4896,486,5382,4896,486,6,15,15,224.25,Tinggi
2012-03-09,1,0,5,1,2,4122,447,4569,4122,447,15,15,15,190.375,Tinggi
2012-03-10,1,0,6,0,1,3150,968,4118,3150,968,14,13,13,171.58333333333334,Sedang
2012-03-11,1,0,0,0,1,3253,1658,4911,3253,1658,13,11,13,213.52173913043478,Tinggi
2012-03-12,1,0,1,1,1,4460,838,5298,4460,838,15,15,15,220.75,Tinggi
2012-03-13,1,0,2,1,1,5085,762,5847,5085,762,15,15,15,243.625,Tinggi
2012-03-14,1,0,3,1,1,5315,997,6312,5315,997,15,14,14,263.0,
2012-03-15,1,0,4,1,1,5187,1005,6192,5187,1005,15,12,15,258.0,
2012-03-16,1,0,5,1,2,3830,548,4378,3830,548,5,9,5,182.41666666666666,Sedang
2012-03-17,1,0,6,0,2,4681,3155,7836,4681,3155,10,13,11,326.5,
2012-03-18,1,0,0,0,2,3685,2207,5892,3685,2207,10,12,12,245.5,Tinggi
2012-03-19,1,0,1,1,1,5171,982,6153,5171,982,15,15,15,256.375,
2012-03-20,1,0,2,1,1,5042,1051,6093,5042,1051,15,15,15,253.875,
2012-03-21,2,0,3,1,2,5108,1122,6230,5108,1122,15,15,15,259.5833333333333,
2012-03-22,2,0,4,1,1,5537,1334,6871,5537,1334,14,14,14,286.2916666666667,
2012-03-23,2,0,5,1,2,5893,2469,8362,5893,2469,14,14,14,348.4166666666667,
2012-03-24,2,0,6,0,2,2339,1033,3372,2339,1033,7,7,7,140.5,Sedang
2012-03-25,2,0,0,0,2,3464,1532,4996,3464,1532,13,15,13,208.16666666666666,Tinggi
2012-03-26,2,0,1,1,1,4763,795,5558,4763,795,5,15,15,231.58333333333334,Tinggi
2012-03-27,2,0,2,1,1,4571,531,5102,4571,531,15,14,15,212.58333333333334,Tinggi
2012-03-28,2,0,3,1,1,5024,674,5698,5024,674,5,14,5,237.41666666666666,Tinggi
2012-03-29,2,0,4,1,1,5299,834,6133,5299,834,5,12,14,255.54166666666666,
2012-03-30,2,0,5,1,2,4663,796,5459,4663,796,5,14,14,227.45833333333334,Tinggi
2012-03-31,2,0,6,0,2,3934,2301,6235,3934,2301,10,12,10,259.7916666666667,
2012-04-01,2,0,0,0,2,3694,2347,6041,3694,2347,14,12,12,251.70833333333334,
2012-04-02,2,0,1,1,1,4728,1208,5936,4728,1208,13,11,13,258.0869565217391,Tinggi
2012-04-03,2,0,2,1,1,5424,1348,6772,5424,1348,14,12,14,282.1666666666667,
2012-04-04,2,0,3,1,1,5378,1058,6436,5378,1058,4,14,14,268.1666666666667,
2012-04-05,2,0,4,1,1,5265,1192,6457,5265,1192,13,13,13,269.0416666666667,
2012-04-06,2,0,5,1,1,4653,1807,6460,4653,1807,4,10,13,269.1666666666667,
2012-04-07,2,0,6,0,1,3605,3252,6857,3605,3252,11,9,9,285.7083333333333,
2012-04-08,2,0,0,0,1,2939,2230,5169,2939,2230,8,11,10,215.375,Tinggi
2012-04-09,2,0,1,1,1,4680,905,5585,4680,905,4,9,14,232.70833333333334,Tinggi
2012-04-10,2,0,2,1,1,5099,819,5918,5099,819,4,13,13,246.58333333333334,Tinggi
2012-04-11,2,0,3,1,1,4380,482,4862,4380,482,3,12,3,211.3913043478261,Tinggi
2012-04-12,2,0,4,1,1,4746,663,5409,4746,663,3,9,12,225.375,Tinggi
2012-04-13,2,0,5,1,1,5146,1252,6398,5146,1252,12,9,12,266.5833333333333,
2012-04-14,2,0,6,0,1,4665,2795,7460,4665,2795,7,10,7,310.8333333333333,
2012-04-15,2,0,0,0,1,4286,2846,7132,4286,2846,8,8,8,297.1666666666667,
2012-04-16,2,1,1,0,1,5172,1198,6370,5172,1198,12,6,12,265.4166666666667,
2012-04-17,2,0,2,1,1,5702,989,6691,5702,989,12,12,12,278.7916666666667,
2012-04-18,2,0,3,1,2,4020,347,4367,4020,347,3,12,3,181.95833333333334,Sedang
2012-04-19,2,0,4,1,1,5719,846,6565,5719,846,13,13,13,273.5416666666667,
2012-04-20,2,0,5,1,1,5950,1340,7290,5950,1340,12,9,12,303.75,
2012-04-21,2,0,6,0,1,4083,2541,6624,4083,2541,7,8,8,276.0,
2012-04-22,2,0,0,0,3,907,120,1027,907,120,19,19,19,42.791666666666664,Rendah
2012-04-23,2,0,1,1,2,3019,195,3214,3019,195,3,17,3,133.91666666666666,Sedang
2012-04-24,2,0,2,1,1,5115,518,5633,5115,518,12,12,12,234.70833333333334,Tinggi
2012-04-25,2,0,3,1,1,5541,655,6196,5541,655,12,12,12,258.1666666666667,
2012-04-26,2,0,4,1,2,4551,475,5026,4551,475,13,13,13,209.41666666666666,Tinggi
2012-04-27,2,0,5,1,1,5219,1014,6233,5219,1014,12,11,12,259.7083333333333,
2012-04-28,2,0,6,0,2,3100,1120,4220,3100,1120,9,10,9,175.83333333333334,Sedang
2012-04-29,2,0,0,0,1,4075,2229,6304,4075,2229,9,9,9,262.6666666666667,
2012-04-30,2,0,1,1,2,4907,665,5572,4907,665,12,12,12,232.16666666666666,Tinggi
2012-05-01,2,0,2,1,2,5087,653,5740,5087,653,13,13,13,239.16666666666666,Tinggi
2012-05-02,2,0,3,1,1,5502,667,6169,5502,667,13,12,13,257.0416666666667,
2012-05-03,2,0,4,1,2,5657,764,6421,5657,764,13,12,13,267.5416666666667,
2012-05-04,2,0,5,1,1,5227,1069,6296,5227,1069,3,10,12,262.3333333333333,
2012-05-05,2,0,6,0,2,4387,2496,6883,4387,2496,6,10,6,286.7916666666667,
2012-05-06,2,0,0,0,2,4224,2135,6359,4224,2135,8,10,10,264.9583333333333,
2012-05-07,2,0,1,1,2,5265,1008,6273,5265,1008,12,12,12,261.375,
2012-05-08,2,0,2,1,2,4990,738,5728,4990,738,13,12,12,238.66666666666666,Tinggi
2012-05-09,2,0,3,1,2,4097,620,4717,4097,620,12,12,12,196.54166666666666,Tinggi
2012-05-10,2,0,4,1,1,5546,1026,6572,5546,1026,13,13,13,273.8333333333333,
2012-05-11,2,0,5,1,1,5711,1319,7030,5711,1319,12,10,12,292.9166666666667,
2012-05-12,2,0,6,0,1,4807,2622,7429,4807,2622,13,8,8,309.5416666666667,
2012-05-13,2,0,0,0,1,3946,2172,6118,3946,2172,8,8,8,254.91666666666666,
2012-05-14,2,0,1,1,2,2501,342,2843,2501,342,14,7,14,118.45833333333333,Sedang
2012-05-15,2,0,2,1,2,4490,625,5115,4490,625,13,12,13,213.125,Tinggi
2012-05-16,2,0,3,1,1,6433,991,7424,6433,991,12,12,12,309.3333333333333,
2012-05-17,2,0,4,1,1,6142,1242,7384,6142,1242,13,13,13,307.6666666666667,
2012-05-18,2,0,5,1,1,6118,1521,7639,6118,1521,3,11,12,318.2916666666667,
2012-05-19,2,0,6,0,1,4884,3410,8294,4884,3410,13,9,9,345.5833333333333,
2012-05-20,2,0,0,0,1,4425,2704,7129,4425,2704,7,6,7,297.0416666666667,
2012-05-21,2,0,1,1,2,3729,630,4359,3729,630,13,10,13,181.625,Sedang
2012-05-22,2,0,2,1,2,5254,819,6073,5254,819,12,7,12,253.04166666666666,
2012-05-23,2,0,3,1,2,4494,766,5260,4494,766,3,8,3,219.16666666666666,Tinggi
2012-05-24,2,0,4,1,1,5711,1059,6770,5711,1059,12,12,12,282.0833333333333,
2012-05-25,2,0,5,1,1,5317,1417,6734,5317,1417,3,11,12,280.5833333333333,
2012-05-26,2,0,6,0,1,3681,2855,6536,3681,2855,6,9,9,272.3333333333333,
2012-05-27,2,0,0,0,1,3308,3283,6591,3308,3283,7,9,7,274.625,
2012-05-28,2,1,1,0,1,3486,2557,6043,3486,2557,7,8,8,251.79166666666666,
2012-05-29,2,0,2,1,1,4863,880,5743,4863,880,12,12,12,239.29166666666666,Tinggi
2012-05-30,2,0,3,1,2,6110,745,6855,6110,745,12,12,12,285.625,
2012-05-31,2,0,4,1,1,6238,1100,7338,6238,1100,12,14,12,305.75,
2012-06-01,2,0,5,1,2,3594,533,4127,3594,533,3,8,3,171.95833333333334,Sedang
2012-06-02,2,0,6,0,1,5325,2795,8120,5325,2795,7,10,10,338.3333333333333,
2012-06-03,2,0,0,0,1,5147,2494,7641,5147,2494,11,7,8,318.375,
2012-06-04,2,0,1,1,1,5927,1071,6998,5927,1071,12,13,12,291.5833333333333,
2012-06-05,2,0,2,1,2,6033,968,7001,6033,968,12,13,12,291.7083333333333,
2012-06-06,2,0,3,1,1,6028,1027,7055,6028,1027,13,9,13,293.9583333333333,
2012-06-07,2,0,4,1,1,6456,1038,7494,6456,1038,12,13,12,312.25,
2012-06-08,2,0,5,1,1,6248,1488,7736,6248,1488,12,13,12,322.3333333333333,
2012-06-09,2,0,6,0,1,4790,2708,7498,4790,2708,9,9,9,312.4166666666667,
2012-06-10,2,0,0,0,1,4374,2224,6598,4374,2224,12,8,12,274.9166666666667,
2012-06-11,2,0,1,1,2,5647,1017,6664,5647,1017,13,13,13,277.6666666666667,
2012-06-12,2,0,2,1,2,4495,477,4972,4495,477,12,13,12,207.16666666666666,Tinggi
2012-06-13,2,0,3,1,1,6248,1173,7421,6248,1173,12,14,12,309.2083333333333,
2012-06-14,2,0,4,1,1,6183,1180,7363,6183,1180,12,12,12,306.7916666666667,
2012-06-15,2,0,5,1,1,6102,1563,7665,6102,1563,12,11,12,319.375,
2012-06-16,2,0,6,0,1,4739,2963,7702,4739,2963,6,10,8,320.9166666666667,
2012-06-17,2,0,0,0,1,4344,2634,6978,4344,2634,12,8,7,290.75,
2012-06-18,2,0,1,1,2,4446,653,5099,4446,653,12,10,12,212.45833333333334,Tinggi
2012-06-19,2,0,2,1,1,5857,968,6825,5857,968,12,13,12,284.375,
2012-06-20,2,0,3,1,1,5339,872,6211,5339,872,12,14,12,258.7916666666667,
2012-06-21,3,0,4,1,1,5127,778,5905,5127,778,3,14,13,246.04166666666666,Tinggi
2012-06-22,3,0,5,1,1,4859,964,5823,4859,964,3,12,12,242.625,Tinggi
2012-06-23,3,0,6,0,1,4801,2657,7458,4801,2657,7,9,9,310.75,
2012-06-24,3,0,0,0,1,4340,2551,6891,4340,2551,8,9,8,287.125,
2012-06-25,3,0,1,1,1,5640,1139,6779,5640,1139,12,11,12,282.4583333333333,
2012-06-26,3,0,2,1,1,6365,1077,7442,6365,1077,12,13,12,310.0833333333333,
2012-06-27,3,0,3,1,1,6258,1077,7335,6258,1077,12,12,12,305.625,
2012-06-28,3,0,4,1,1,5958,921,6879,5958,921,12,13,12,286.625,
2012-06-29,3,0,5,1,1,4634,829,5463,4634,829,3,12,3,227.625,Tinggi
2012-06-30,3,0,6,0,1,4232,1455,5687,4232,1455,6,7,7,236.95833333333334,Tinggi
2012-07-01,3,0,0,0,1,4110,1421,5531,4110,1421,9,6,9,230.45833333333334,Tinggi
2012-07-02,3,0,1,1,1,5323,904,6227,5323,904,12,12,12,259.4583333333333,
2012-07-03,3,0,2,1,1,5608,1052,6660,5608,1052,12,12,12,277.5,
2012-07-04,3,1,3,0,1,4841,2562,7403,4841,2562,16,15,16,308.4583333333333,
2012-07-05,3,0,4,1,1,4836,1405,6241,4836,1405,12,8,12,260.0416666666667,
2012-07-06,3,0,5,1,1,4841,1366,6207,4841,1366,3,14,3,258.625,
2012-07-07,3,0,6,0,1,3392,1448,4840,3392,1448,6,7,6,201.66666666666666,Tinggi
2012-07-08,3,0,0,0,1,3469,1203,4672,3469,1203,7,6,6,194.66666666666666,Tinggi
2012-07-09,3,0,1,1,2,5571,998,6569,5571,998,13,12,13,273.7083333333333,
2012-07-10,3,0,2,1,2,5336,954,6290,5336,954,12,12,12,262.0833333333333,
2012-07-11,3,0,3,1,1,6289,975,7264,6289,975,12,12,12,302.6666666666667,
2012-07-12,3,0,4,1,1,6414,1032,7446,6414,1032,13,14,13,310.25,
2012-07-13,3,0,5,1,2,5988,1511,7499,5988,1511,12,12,12,312.4583333333333,
2012-07-14,3,0,6,0,2,4614,2355,6969,4614,2355,8,9,9,290.375,
2012-07-15,3,0,0,0,1,4111,1920,6031,4111,1920,11,10,11,251.29166666666666,
2012-07-16,3,0,1,1,1,5742,1088,6830,5742,1088,13,13,13,284.5833333333333,
2012-07-17,3,0,2,1,1,5865,921,6786,5865,921,13,12,13,282.75,
2012-07-18,3,0,3,1,1,4914,799,5713,4914,799,3,14,3,238.04166666666666,Tinggi
2012-07-19,3,0,4,1,1,5703,888,6591,5703,888,13,12,13,274.625,
2012-07-20,3,0,5,1,2,5123,747,5870,5123,747,3,12,12,244.58333333333334,Tinggi
2012-07-21,3,0,6,0,3,3195,1264,4459,3195,1264,7,7,7,185.79166666666666,Sedang
2012-07-22,3,0,0,0,2,4866,2544,7410,4866,2544,8,9,11,308.75,
2012-07-23,3,0,1,1,1,5831,1135,6966,5831,1135,12,11,12,290.25,
2012-07-24,3,0,2,1,1,6452,1140,7592,6452,1140,12,13,13,316.3333333333333,
2012-07-25,3,0,3,1,1,6790,1383,8173,6790,1383,13,12,12,340.5416666666667,
2012-07-26,3,0,4,1,1,5825,1036,6861,5825,1036,3,12,12,285.875,
2012-07-27,3,0,5,1,1,5645,1259,6904,5645,1259,3,9,12,287.6666666666667,
2012-07-28,3,0,6,0,1,4451,2234,6685,4451,2234,7,11,8,278.5416666666667,
2012-07-29,3,0,0,0,1,4444,2153,6597,4444,2153,12,9,12,274.875,
2012-07-30,3,0,1,1,1,6065,1040,7105,6065,1040,12,11,12,296.0416666666667,
2012-07-31,3,0,2,1,1,6248,968,7216,6248,968,13,13,13,300.6666666666667,
2012-08-01,3,0,3,1,1,6506,1074,7580,6506,1074,13,13,13,315.8333333333333,
2012-08-02,3,0,4,1,1,6278,983,7261,6278,983,12,8,12,302.5416666666667,
2012-08-03,3,0,5,1,2,5847,1328,7175,5847,1328,12,10,12,298.9583333333333,
2012-08-04,3,0,6,0,1,4479,2345,6824,4479,2345,8,7,7,284.3333333333333,
2012-08-05,3,0,0,0,1,3757,1707,5464,3757,1707,9,8,9,227.66666666666666,Tinggi
2012-08-06,3,0,1,1,2,5780,1233,7013,5780,1233,12,12,12,292.2083333333333,
2012-08-07,3,0,2,1,2,5995,1278,7273,5995,1278,12,12,12,303.0416666666667,
2012-08-08,3,0,3,1,2,6271,1263,7534,6271,1263,12,14,13,313.9166666666667,
2012-08-09,3,0,4,1,1,6090,1196,7286,6090,1196,13,12,13,303.5833333333333,
2012-08-10,3,0,5,1,2,4721,1065,5786,4721,1065,12,12,12,241.08333333333334,Tinggi
2012-08-11,3,0,6,0,2,4052,2247,6299,4052,2247,8,9,8,262.4583333333333,
2012-08-12,3,0,0,0,1,4362,2182,6544,4362,2182,9,10,9,272.6666666666667,
2012-08-13,3,0,1,1,1,5676,1207,6883,5676,1207,12,11,12,286.7916666666667,
2012-08-14,3,0,2,1,1,5656,1128,6784,5656,1128,13,13,13,282.6666666666667,
2012-08-15,3,0,3,1,1,6149,1198,7347,6149,1198,13,14,12,306.125,
2012-08-16,3,0,4,1,1,6267,1338,7605,6267,1338,12,12,12,316.875,
2012-08-17,3,0,5,1,1,5665,1483,7148,5665,1483,12,12,12,297.8333333333333,
2012-08-18,3,0,6,0,1,5038,2827,7865,5038,2827,7,8,7,327.7083333333333,
2012-08-19,3,0,0,0,2,3341,1208,4549,3341,1208,13,5,5,189.54166666666666,Tinggi
2012-08-20,3,0,1,1,2,5504,1026,6530,5504,1026,12,11,12,272.0833333333333,
2012-08-21,3,0,2,1,1,5925,1081,7006,5925,1081,12,9,12,291.9166666666667,
2012-08-22,3,0,3,1,1,6281,1094,7375,6281,1094,12,11,12,307.2916666666667,
2012-08-23,3,0,4,1,1,6402,1363,7765,6402,1363,13,13,13,323.5416666666667,
2012-08-24,3,0,5,1,2,6257,1325,7582,6257,1325,3,12,12,315.9166666666667,
2012-08-25,3,0,6,0,2,4224,1829,6053,4224,1829,7,7,7,252.20833333333334,
2012-08-26,3,0,0,0,2,3772,1483,5255,3772,1483,7,7,7,218.95833333333334,Tinggi
2012-08-27,3,0,1,1,1,5928,989,6917,5928,989,13,12,12,288.2083333333333,
2012-08-28,3,0,2,1,1,6105,935,7040,6105,935,12,12,12,293.3333333333333,
2012-08-29,3,0,3,1,1,6520,1177,7697,6520,1177,3,14,12,320.7083333333333,
2012-08-30,3,0,4,1,1,6541,1172,7713,6541,1172,12,13,13,321.375,
2012-08-31,3,0,5,1,1,5917,1433,7350,5917,1433,3,12,3,306.25,
2012-09-01,3,0,6,0,2,3788,2352,6140,3788,2352,10,10,10,255.83333333333334,
2012-09-02,3,0,0,0,2,3197,2613,5810,3197,2613,7,8,7,242.08333333333334,Tinggi
2012-09-03,3,1,1,0,1,4069,1965,6034,4069,1965,8,8,8,251.41666666666666,
2012-09-04,3,0,2,1,1,5997,867,6864,5997,867,12,12,12,286.0,
2012-09-05,3,0,3,1,1,6280,832,7112,6280,832,12,11,12,296.3333333333333,
2012-09-06,3,0,4,1,2,5592,611,6203,5592,611,13,13,13,258.4583333333333,
2012-09-07,3,0,5,1,1,6459,1045,7504,6459,1045,13,13,13,312.6666666666667,
2012-09-08,3,0,6,0,2,4419,1557,5976,4419,1557,7,9,7,249.0,Tinggi
2012-09-09,3,0,0,0,1,5657,2570,8227,5657,2570,7,10,7,342.7916666666667,
2012-09-10,3,0,1,1,1,6407,1118,7525,6407,1118,13,12,13,313.5416666666667,
2012-09-11,3,0,2,1,1,6697,1070,7767,6697,1070,12,12,12,323.625,
2012-09-12,3,0,3,1,1,6820,1050,7870,6820,1050,13,12,13,327.9166666666667,
2012-09-13,3,0,4,1,1,6750,1054,7804,6750,1054,12,13,12,325.1666666666667,
2012-09-14,3,0,5,1,1,6630,1379,8009,6630,1379,12,12,12,333.7083333333333,
2012-09-15,3,0,6,0,1,5554,3160,8714,5554,3160,12,11,11,363.0833333333333,
2012-09-16,3,0,0,0,1,5167,2166,7333,5167,2166,7,8,8,305.5416666666667,
2012-09-17,3,0,1,1,2,5847,1022,6869,5847,1022,12,9,12,286.2083333333333,
2012-09-18,3,0,2,1,2,3702,371,4073,3702,371,3,6,3,169.70833333333334,Sedang
2012-09-19,3,0,3,1,1,6803,788,7591,6803,788,12,13,13,316.2916666666667,
2012-09-20,3,0,4,1,1,6781,939,7720,6781,939,12,13,12,321.6666666666667,
2012-09-21,3,0,5,1,1,6917,1250,8167,6917,1250,12,9,12,340.2916666666667,
2012-09-22,3,0,6,0,1,5883,2512,8395,5883,2512,7,10,10,349.7916666666667,
2012-09-23,4,0,0,0,1,5453,2454,7907,5453,2454,7,9,7,329.4583333333333,
2012-09-24,4,0,1,1,1,6435,1001,7436,6435,1001,12,11,12,309.8333333333333,
2012-09-25,4,0,2,1,1,6693,845,7538,6693,845,12,12,12,314.0833333333333,
2012-09-26,4,0,3,1,1,6946,787,7733,6946,787,12,12,12,322.2083333333333,
2012-09-27,4,0,4,1,2,6642,751,7393,6642,751,13,12,12,308.0416666666667,
2012-09-28,4,0,5,1,2,6370,1045,7415,6370,1045,12,6,12,308.9583333333333,
2012-09-29,4,0,6,0,1,5966,2589,8555,5966,2589,7,9,9,356.4583333333333,
2012-09-30,4,0,0,0,1,4874,2015,6889,4874,2015,7,10,7,287.0416666666667,
2012-10-01,4,0,1,1,2,6015,763,6778,6015,763,12,10,12,282.4166666666667,
2012-10-02,4,0,2,1,3,4324,315,4639,4324,315,12,13,12,193.29166666666666,Tinggi
2012-10-03,4,0,3,1,2,6844,728,7572,6844,728,12,12,12,315.5,
2012-10-04,4,0,4,1,2,6437,891,7328,6437,891,13,12,12,305.3333333333333,
2012-10-05,4,0,5,1,1,6640,1516,8156,6640,1516,3,7,12,339.8333333333333,
2012-10-06,4,0,6,0,1,4934,3031,7965,4934,3031,8,7,7,331.875,
2012-10-07,4,0,0,0,2,2729,781,3510,2729,781,7,7,7,146.25,Sedang
2012-10-08,4,1,1,0,2,4604,874,5478,4604,874,12,9,12,228.25,Tinggi
2012-10-09,4,0,2,1,2,5791,601,6392,5791,601,13,12,12,266.3333333333333,
2012-10-10,4,0,3,1,1,6911,780,7691,6911,780,12,11,12,320.4583333333333,
2012-10-11,4,0,4,1,1,6736,834,7570,6736,834,3,10,12,315.4166666666667,
2012-10-12,4,0,5,1,1,6222,1060,7282,6222,1060,3,10,12,303.4166666666667,
2012-10-13,4,0,6,0,1,4857,2252,7109,4857,2252,8,11,8,296.2083333333333,
2012-10-14,4,0,0,0,1,4559,2080,6639,4559,2080,8,9,8,276.625,
2012-10-15,4,0,1,1,2,5115,760,5875,5115,760,3,12,12,244.79166666666666,Tinggi
2012-10-16,4,0,2,1,1,6612,922,7534,6612,922,12,12,12,313.9166666666667,
2012-10-17,4,0,3,1,1,6482,979,7461,6482,979,13,12,12,310.875,
2012-10-18,4,0,4,1,2,6501,1008,7509,6501,1008,3,12,12,312.875,
2012-10-19,4,0,5,1,2,4671,753,5424,4671,753,3,11,11,226.0,Tinggi
2012-10-20,4,0,6,0,1,5284,2806,8090,5284,2806,8,12,12,337.0833333333333,
2012-10-21,4,0,0,0,1,4692,2132,6824,4692,2132,7,8,7,284.3333333333333,
2012-10-22,4,0,1,1,1,6228,830,7058,6228,830,12,8,12,294.0833333333333,
2012-10-23,4,0,2,1,1,6625,841,7466,6625,841,12,11,12,311.0833333333333,
2012-10-24,4,0,3,1,1,6898,795,7693,6898,795,12,12,12,320.5416666666667,
2012-10-25,4,0,4,1,2,6484,875,7359,6484,875,12,12,12,306.625,
2012-10-26,4,0,5,1,2,6262,1182,7444,6262,1182,3,10,12,310.1666666666667,
2012-10-27,4,0,6,0,2,5209,2643,7852,5209,2643,8,9,8,327.1666666666667,
2012-10-28,4,0,0,0,2,3461,998,4459,3461,998,7,4,7,185.79166666666666,Sedang
2012-10-29,4,0,1,1,3,20,2,22,20,2,19,19,19,22.0,Rendah
2012-10-30,4,0,2,1,2,1009,87,1096,1009,87,1,0,1,99.63636363636364,Rendah
2012-10-31,4,0,3,1,2,5147,419,5566,5147,419,0,23,0,231.91666666666666,Tinggi
2012-11-01,4,0,4,1,2,5520,466,5986,5520,466,15,1,0,249.41666666666666,Tinggi
2012-11-02,4,0,5,1,1,5229,618,5847,5229,618,15,20,15,243.625,Tinggi
2012-11-03,4,0,6,0,2,4109,1029,5138,4109,1029,20,21,21,214.08333333333334,Tinggi
2012-11-04,4,0,0,0,1,3906,1201,5107,3906,1201,20,19,21,212.79166666666666,Tinggi
2012-11-05,4,0,1,1,1,4881,378,5259,4881,378,15,20,15,219.125,Tinggi
2012-11-06,4,0,2,1,1,5220,466,5686,5220,466,0,20,0,236.91666666666666,Tinggi
2012-11-07,4,0,3,1,2,4709,326,5035,4709,326,15,7,15,209.79166666666666,Tinggi
2012-11-08,4,0,4,1,1,4975,340,5315,4975,340,14,23,14,231.08695652173913,Tinggi
2012-11-09,4,0,5,1,1,5283,709,5992,5283,709,14,21,14,249.66666666666666,Tinggi
2012-11-10,4,0,6,0,1,4446,2090,6536,4446,2090,19,20,19,272.3333333333333,
2012-11-11,4,0,0,0,1,4562,2290,6852,4562,2290,19,21,21,285.5,
2012-11-12,4,1,1,0,1,5172,1097,6269,5172,1097,23,20,23,261.2083333333333,
2012-11-13,4,0,2,1,2,3767,327,4094,3767,327,23,0,23,170.58333333333334,Sedang
2012-11-14,4,0,3,1,1,5122,373,5495,5122,373,14,18,14,228.95833333333334,Tinggi
2012-11-15,4,0,4,1,2,5125,320,5445,5125,320,14,18,14,226.875,Tinggi
2012-11-16,4,0,5,1,1,5214,484,5698,5214,484,14,19,14,237.41666666666666,Tinggi
2012-11-17,4,0,6,0,1,4316,1313,5629,4316,1313,20,19,20,234.54166666666666,Tinggi
2012-11-18,4,0,0,0,1,3747,922,4669,3747,922,18,20,19,194.54166666666666,Tinggi
2012-11-19,4,0,1,1,2,5050,449,5499,5050,449,14,22,14,229.125,Tinggi
2012-11-20,4,0,2,1,2,5100,534,5634,5100,534,14,18,14,234.75,Tinggi
2012-11-21,4,0,3,1,1,4531,615,5146,4531,615,14,20,14,214.41666666666666,Tinggi
2012-11-22,4,1,4,0,1,1470,955,2425,1470,955,16,21,19,101.04166666666667,Sedang
2012-11-23,4,0,5,1,1,2307,1603,3910,2307,1603,21,20,21,162.91666666666666,Sedang
2012-11-24,4,0,6,0,1,1745,532,2277,1745,532,19,19,19,94.875,Sedang
2012-11-25,4,0,0,0,1,2115,309,2424,2115,309,21,17,21,101.0,Sedang
2012-11-26,4,0,1,1,1,4750,337,5087,4750,337,14,20,14,211.95833333333334,Tinggi
2012-11-27,4,0,2,1,2,3836,123,3959,3836,123,23,23,23,164.95833333333334,Sedang
2012-11-28,4,0,3,1,1,5062,198,5260,5062,198,14,19,14,219.16666666666666,Tinggi
2012-11-29,4,0,4,1,1,5080,243,5323,5080,243,13,15,13,231.43478260869566,Tinggi
2012-11-30,4,0,5,1,1,5306,362,5668,5306,362,13,21,13,236.16666666666666,Tinggi
2012-12-01,4,0,6,0,2,4240,951,5191,4240,951,18,18,18,216.29166666666666,Tinggi
2012-12-02,4,0,0,0,2,3757,892,4649,3757,892,17,19,17,193.70833333333334,Tinggi
2012-12-03,4,0,1,1,1,5679,555,6234,5679,555,13,18,13,259.75,
2012-12-04,4,0,2,1,1,6055,551,6606,6055,551,13,20,22,275.25,
2012-12-05,4,0,3,1,1,5398,331,5729,5398,331,13,19,13,238.70833333333334,Tinggi
2012-12-06,4,0,4,1,1,5035,340,5375,5035,340,13,21,13,223.95833333333334,Tinggi
2012-12-07,4,0,5,1,2,4659,349,5008,4659,349,22,19,22,208.66666666666666,Tinggi
2012-12-08,4,0,6,0,2,4429,1153,5582,4429,1153,18,20,18,232.58333333333334,Tinggi
2012-12-09,4,0,0,0,2,2787,441,3228,2787,441,17,18,17,134.5,Sedang
2012-12-10,4,0,1,1,2,4841,329,5170,4841,329,22,22,22,215.41666666666666,Tinggi
2012-12-11,4,0,2,1,2,5219,282,5501,5219,282,13,16,13,229.20833333333334,Tinggi
2012-12-12,4,0,3,1,2,5009,310,5319,5009,310,13,19,13,221.625,Tinggi
2012-12-13,4,0,4,1,1,5107,425,5532,5107,425,13,21,13,230.5,Tinggi
2012-12-14,4,0,5,1,1,5182,429,5611,5182,429,13,20,13,233.79166666666666,Tinggi
2012-12-15,4,0,6,0,1,4280,767,5047,4280,767,18,20,18,210.29166666666666,Tinggi
2012-12-16,4,0,0,0,2,3248,538,3786,3248,538,17,17,17,157.75,Sedang
2012-12-17,4,0,1,1,2,4373,212,4585,4373,212,13,16,13,191.04166666666666,Tinggi
2012-12-18,4,0,2,1,1,5124,433,5557,5124,433,13,16,13,231.54166666666666,Tinggi
2012-12-19,4,0,3,1,1,4934,333,5267,4934,333,13,21,13,219.45833333333334,Tinggi
2012-12-20,4,0,4,1,2,3814,314,4128,3814,314,13,18,13,172.0,Sedang
2012-12-21,1,0,5,1,2,3402,221,3623,3402,221,13,20,13,150.95833333333334,Sedang
2012-12-22,1,0,6,0,1,1544,205,1749,1544,205,19,16,19,72.875,Rendah
2012-12-23,1,0,0,0,1,1379,408,1787,1379,408,17,18,17,74.45833333333333,Rendah
2012-12-24,1,0,1,1,2,746,174,920,746,174,16,16,16,40.0,Rendah
2012-12-25,1,1,2,0,2,573,440,1013,573,440,17,16,17,44.04347826086956,Rendah
2012-12-26,1,0,3,1,3,432,9,441,432,9,20,20,20,18.375,Rendah
2012-12-27,1,0,4,1,2,1867,247,2114,1867,247,20,18,20,88.08333333333333,Sedang
2012-12-28,1,0,5,1,2,2451,644,3095,2451,644,11,17,20,128.95833333333334,Sedang
2012-12-29,1,0,6,0,2,1182,159,1341,1182,159,19,19,19,55.875,Rendah
2012-12-30,1,0,0,0,1,1432,364,1796,1432,364,17,16,16,74.83333333333333,Rendah
2012-12-31,1,0,1,1,2,2290,439,2729,2290,439,18,18,18,113.70833333333333,Sedang
